0 1 0 1 41 42 26 27 0 1 41 42 32 33 0 1 41 42 6 7 80 81 45 46 32 33 43 44 41 42 45 46 32 33 43 44 41 42 45 46 32 33 6 7 32 33 47 14
0 1 0 1 2 3 11 12 0 1 2 3 8 9 0 1 2 3 4 5 20 21 22 23 0 1 24 25 2 3 22 23 0 1 24 25 2 3 22 23 0 1 6 7 8 9 13 14
32 33 26 27 2 3 32 33 32 33 2 3 10 10 32 33 2 3 28 29 26 27 32 33 41 42 43 44 2 3 45 46 41 42 43 44 2 3 45 46 41 42 6 34 10 10 47 14
0 1 11 12 2 3 0 1 0 1 2 3 10 10 0 1 2 3 48 49 11 12 0 1 2 3 24 25 2 3 22 23 2 3 24 25 2 3 22 23 2 3 4 5 10 10 13 14
61 62 63 63 63 63 64 65 66 67 2 3 10 10 32 33 2 3 35 36 32 33 32 33 2 3 32 33 2 3 32 33 2 3 32 33 2 3 30 31 2 3 35 36 10 10 16 37
19 19 19 19 19 19 19 73 74 75 2 3 10 10 0 1 2 3 50 51 0 1 0 1 2 3 0 1 2 3 0 1 2 3 0 1 2 3 8 9 2 3 50 51 10 10 16 52
6 34 32 33 41 42 80 81 73 82 63 63 61 62 63 63 63 63 64 65 66 67 32 33 2 3 32 33 2 3 32 33 2 3 32 33 2 3 26 27 2 3 55 56 57 58 16 68
4 5 0 1 2 3 20 21 19 19 19 19 19 19 19 19 19 19 19 73 74 75 0 1 2 3 0 1 2 3 0 1 2 3 0 1 2 3 11 12 2 3 71 57 72 19 19 19
35 36 32 33 2 3 32 33 30 31 2 3 26 27 2 3 26 27 80 81 73 74 66 67 2 3 32 33 2 3 32 33 2 3 32 33 2 3 32 33 2 3 77 72 78 79 47 14
50 51 0 1 2 3 0 1 8 9 2 3 11 12 2 3 11 12 20 21 96 73 74 75 2 3 0 1 2 3 0 1 2 3 0 1 2 3 0 1 2 3 19 38 89 90 13 14
61 62 61 62 59 60 61 62 61 62 59 60 61 62 59 60 61 62 61 62 61 62 73 82 59 60 61 62 59 60 61 62 59 60 61 62 59 60 61 62 59 60 61 62 61 61 97 14
19 19 19 19 19 19 19 19 19 19 19 19 19 19 19 19 19 19 19 19 19 19 19 19 19 19 19 19 19 19 19 19 19 19 19 19 19 19 19 19 19 19 19 19 19 19 19 19
