0 0 1 2 1 2 1 2 1 2 1 2 0 0 0 0 0 0 1 2 1 2 1 2 1 2 1 2 0 0 0 0 0 0 0 0 0 0 0 0 3 4 5 6 5 6 7 8
9 10 9 10 9 10 9 10 9 10 9 10 0 0 0 0 9 10 9 10 9 10 9 10 9 10 9 10 0 0 0 0 0 0 0 0 0 0 0 0 8 8 4 11 4 11 12 8
13 14 13 14 13 14 13 14 13 14 13 14 1 2 1 2 13 14 13 14 13 14 13 14 13 14 13 14 1 2 1 2 1 2 1 2 1 2 1 2 8 15 16 11 16 11 17 8
21 18 19 20 21 18 21 18 21 18 21 18 21 18 21 18 21 18 19 20 21 18 21 18 21 18 21 18 21 18 21 18 21 18 21 18 19 20 19 20 8 4 23 24 4 11 25 8
29 26 27 28 29 26 29 26 29 26 29 26 29 26 29 26 29 26 27 28 29 26 29 26 29 26 29 26 29 26 29 26 29 26 29 26 27 28 27 28 8 30 31 8 16 11 7 8
32 22 8 8 32 22 32 22 32 22 32 22 32 22 32 22 32 22 8 8 32 22 32 22 32 22 32 22 32 22 32 22 32 22 32 22 8 8 8 8 8 4 25 8 4 11 12 8
27 28 33 34 27 28 27 28 27 28 27 28 27 28 27 28 27 28 33 34 27 28 27 28 27 28 27 28 27 28 27 28 27 28 27 28 33 34 8 8 8 30 7 8 16 11 60 8
35 36 37 38 8 8 8 36 35 36 8 8 35 36 8 8 35 36 37 38 8 8 8 36 35 36 8 8 35 36 8 8 8 8 8 8 37 38 8 8 8 30 41 8 30 42 12 8
42 43 44 45 46 47 48 49 48 49 46 47 48 49 46 47 48 49 44 45 46 47 48 49 48 49 46 47 48 49 46 47 46 47 50 51 52 53 54 55 56 57 58 8 58 59 60 8
61 62 61 62 61 62 61 62 61 62 61 62 61 62 61 62 61 62 61 62 61 62 61 62 61 62 61 62 61 62 61 62 61 62 61 62 61 62 61 62 61 62 61 62 61 62 61 62
8 8 8 8 8 8 8 8 8 8 8 8 8 8 8 8 8 8 8 8 8 8 8 8 8 8 8 8 8 8 8 8 8 8 8 8 8 8 8 8 8 8 8 8 8 8 8 8
8 8 8 8 8 8 8 8 8 8 8 8 8 8 8 8 8 8 8 8 8 8 8 8 8 8 8 8 8 8 8 8 8 8 8 8 8 8 8 8 8 8 8 8 8 8 8 8