0 0 13 26 45 45 45 45 13 26 19 19 19 19 19 19 19 19 19 19 19 19 19 19 19 19 19 19 19 19 19 19 19 19 19 19 19 19 19 19 19 19 19 19 19 19 0 0
0 0 14 13 45 45 45 45 14 13 19 19 19 19 19 19 19 19 19 19 19 19 19 19 19 19 19 19 19 19 19 19 19 19 19 19 19 19 19 19 19 19 19 19 19 19 0 0
0 0 45 45 45 45 24 25 45 45 19 19 19 19 19 19 45 46 45 46 19 19 19 19 19 19 19 19 38 50 19 19 19 19 19 19 19 19 19 19 19 19 45 46 45 46 0 0
0 0 45 45 45 45 36 37 45 45 19 19 19 19 19 19 45 45 45 45 19 19 19 19 19 19 19 19 51 52 19 19 19 19 19 19 19 19 19 19 30 53 45 45 45 45 0 0
0 0 45 45 45 45 13 26 45 45 19 19 19 19 38 50 5 6 7 8 38 50 19 19 19 19 19 19 10 11 45 46 45 46 45 46 45 46 41 53 42 42 24 25 45 45 0 0
0 0 45 45 45 45 14 13 45 45 19 19 19 19 51 52 17 19 19 20 51 52 19 19 19 19 19 19 11 45 45 45 45 45 45 45 45 45 42 42 42 42 36 37 45 45 42 9
0 0 45 45 24 25 10 11 0 0 19 19 7 8 0 0 19 19 19 19 45 45 38 50 38 50 45 46 3 4 45 45 45 45 0 0 1 2 13 26 24 25 45 45 45 45 42 21
0 0 45 45 36 37 11 45 0 0 19 19 19 20 45 45 57 58 19 19 45 45 51 52 51 52 45 45 15 16 0 0 45 45 12 13 14 1 14 13 36 37 45 45 0 0 42 33
0 0 45 45 10 11 45 45 45 45 41 53 41 53 24 25 13 26 13 26 45 45 45 45 10 11 0 0 13 26 38 50 45 45 5 6 7 8 1 2 45 45 45 45 13 26 0 0
0 0 45 45 11 45 45 45 45 45 42 42 42 42 36 37 14 13 14 13 45 45 45 45 11 45 12 13 14 13 51 52 45 45 17 19 19 20 14 1 45 45 0 0 14 13 0 0
0 0 0 0 22 0 24 25 24 25 0 0 0 0 0 0 0 0 0 0 38 50 0 0 45 45 19 19 0 0 45 45 45 45 19 19 38 50 0 0 0 0 45 45 45 45 0 0
0 0 0 0 13 35 36 37 36 37 45 45 12 13 12 13 12 13 45 45 51 52 12 13 45 45 57 58 12 13 0 0 0 0 57 58 51 52 12 13 12 13 45 45 45 45 0 0